1111111111111111111111111
1000000000000000000000001
1000111111111111111111101
1000000000000000000000001
1011111111111111111111101
1000000000000000000000001
1011111001111111111111101
10000000000000000E0000001
1111111111110P00111111111
1000000000000000000000001
1011111110001111111111101
1000000000K00D00000000001
1011111110001111111111101
1000000000000000000000001
1011111111111111111111101
1000000000000000000000001
1011111111111111111111101
1111111111111111111111111
