1111111111111111111111111
1000000000000000000000001
1000111111111111111111101
100000000000000K000000001
1011111111111111111111101
1000000000000000K00000001
1011111001111111111111101
10000000000000000E0000001
1111111111110000111111111
1000000000000000000000001
1011111110001111111111101
1000000000K00D00000000001
1011111110001111111111100
1000000000000100000C00P00
101111111111111111111C000
1000000000000000000000000
1011111111111111111111101
1111111111111111111111111
