1111111111111111111111111
1000000000000000000000001
1000111111111111111111101
1000000000000000000000001
1011111111111111111111101
1000000000000000000000001
1011111001111111111111101
1000000000000000000000001
1111111111110000111111111
1000000000000000000000001
1011111110001111111111101
1000000000000D00000000001
1011111110000111111111100
100000000000000S000C00P00
1011111111111111111110000
1000000000000000000000000
1011111111111111111111101
1111111111111111111111111
