#########################
#.......................#
#...###################.#
#.......................#
#.#####################.#
#.......................#
#.#####..##############.#
#.......................#
############....#########
#.......................#
#.#######...###########.#
#............D..........#
#.#######.............#..
#..............S...C..P..
#.###################....
#........................
#.#####################.#
#########################
