1111111111111111111111111
1000000000000000000000001
1000111111111111111111101
100000000000000K000000001
1011111111111111111111101
1000000000000000K00000001
1011111001111111111111101
10000000000000000E0000001
1111111111110000111111111
1000000000000000000000001
0011111110001111111111101
0000000000K00D00000000001
0011111110001111111111101
0000000000000000000000P01
0011111111111111111110001
0000000000000000000000001
0011111111111111111111101
1111111111111111111111111
