#########################
#.......................#
#...###################.#
#..............K........#
#.#####################.#
#...............K.......#
#.#####..##############.#
#................E......#
############....#########
#.......................#
..#######...###########.#
..........K..D..........#
..#######...###########.#
......................P.#
..###################...#
........................#
..#####################.#
#########################
